1 5 796 7842 7874 7937 8014 
2 3 8102 4941 7970 
1 4 9443 9501 4664 9581 
3 3 15115 9185 7971 
2 10 9185 15116 15115 8006 7860 9096 9082 4742 8960 7730 
1 7 9491 2046 4793 9298 9236 9170 9096 
2 5 15115 4929 8034 8943 8861 
1 4 8861 8821 8769 4812 
1 4 8861 5765 5218 8606 
2 8 9185 9145 5816 7893 9184 2871 9106 9105 
1 6 2871 5766 9118 9058 1146 8034 
2 4 8959 8923 1359 9003 
2 3 9481 9543 9582 
2 6 9136 9097 9129 9193 18899 4271 
1 5 9193 9194 2039 9300 9324 
2 4 9574 9509 9493 9447 
1 14 5401 5388 7280 7270 7281 3381 7307 7271 393 295 4834 1409 7525 7468 
2 6 3216 7575 1409 7583 7589 5693 
3 5 10322 10323 15118 1316 5503 
2 6 10280 10312 10346 4253 4847 1316 
1 7 5503 10505 10483 10586 10557 4418 3142 
1 4 10280 2041 10203 10155 
2 7 9812 9760 9703 9644 9583 9534 9575 
1 5 9574 403 9603 9639 9703 
1 4 9639 5292 4752 9438 
1 5 9509 9453 7716 4062 9284 
1 3 3633 9417 9447 
1 3 2039 9229 9163 
1 4 2999 9596 5735 9694 
2 5 1050 3116 3836 2843 8274 
1 9 8603 8631 8678 8640 8723 3005 8941 5968 3583 
2 2 9380 9428 
1 5 2106 9429 9437 9475 9428 
1 5 2802 9427 9380 9311 9256 
1 3 8102 8226 8274 
1 4 1899 7602 7563 2944 
1 4 1050 13246 8567 1847 
1 5 13246 3258 8539 8531 4569 
1 4 4075 9743 9684 9667 
1 6 8669 8634 8791 8862 4733 7730 
1 6 9136 9067 9005 8995 7730 8925 
1 4 9136 4753 3257 4742 
1 3 9543 9520 9481 
1 6 9520 9451 9399 9340 9261 7971 
1 4 9623 9728 1473 9837 
1 4 1395 9892 9957 9989 
2 6 8579 8569 8700 492 2600 9001 
2 5 3192 13057 13110 340 9088 
1 6 1168 679 9225 6039 9115 9088 
1 5 9001 9080 4977 9225 1168 
1 3 492 1082 8700 
1 4 2057 8665 548 1082 
1 4 5398 8860 8985 9003 
1 3 1917 7670 7691 
1 5 4857 7394 7425 725 7451 
1 3 5978 7940 7904 
1 15 1837 5824 12135 12095 4698 12159 477 11983 11953 11889 2440 11802 3739 11763 11740 
1 11 16752 2615 322 15050 15065 9 3109 15037 15031 15089 19545 
3 8 5452 7018 279 588 3411 7037 6930 6921 
1 4 588 7170 7233 7234 
1 4 7162 5452 7047 2579 
1 3 6968 3466 6930 
1 5 6955 6885 588 7142 4913 
1 5 4831 6866 6921 4359 3520 
2 3 842 7054 7002 
1 8 7039 7010 3310 7002 6950 6931 6898 6868 
1 3 6795 6745 3713 
2 14 6745 6729 6728 6706 6669 6646 5507 6552 4482 6500 6469 96 6460 6441 
1 8 6460 57 2266 1586 6057 3854 6576 2606 
1 9 2266 6532 6537 4194 6552 4860 6531 6512 5215 
2 7 5159 6224 6674 1342 6653 1966 6646 
1 13 6582 6560 6540 4267 743 6484 6474 6463 6468 6481 5215 6059 6481 
1 2 6474 6459 
1 5 7707 1724 7814 7876 7915 
1 7 7572 6212 634 1046 7851 7861 7876 
1 7 4886 2161 7677 3915 4723 5235 2446 
